-20
21
-10
15
000000000000000000000000000000000000000000
000000000000000000000000000000000000000000
111111111111111111111111111111111111111110
000000000000000000000000000000000000000000
000000000000000000000000000000000000000000
000000000000000000000000000000000000000000
000000000000000000000000000000000000000000
000000000000000000000000000000000000000000
000000000000000000000000000000000000000000
000000000000000000000000000000000000000000
000000000000000000000000000000000000000000
000000000000000000000000000011000000000000
000000000000000000000000011111110000000000
000000000000000000000000011111110000000000
000000000000000000000000011111110000000000
000000000000000000000000011111110000000000
000000000000000000000000011111110000000000
000000000000000000000000011111110000000000
000000000000000000000000011111110000000000
000000000100000000000000000000000000000000
000000000000000000000000000000000000000000
000000000000000000000000000000000010000000
000000000000000100000000000000000000000000
000000000000000001000000000000000000000000
000000000000000000000000001000000000000000
000000000000000000000000000000000000000000
